Job,Production_Plan_ID,Operation,Machine,Arrival,Deadline,Start,Processing Time,End,Lateness,Tardiness,Earliness
1,1,0,M00,136,2401,1440,43,1483,-918,0,918
3,3,0,M01,236,1873,1440,81,1521,-352,0,352
15,7,0,M02,1193,3082,1440,31,1471,-1611,0,1611
4,4,0,M02,404,3093,1471,14,1485,-1608,0,1608
12,8,0,M00,992,2717,1483,76,1559,-1158,0,1158
7,7,0,M02,528,4218,1485,31,1516,-2702,0,2702
3,3,1,M02,236,1873,1521,95,1616,-257,0,257
6,6,0,M01,501,2430,1521,46,1567,-863,0,863
10,0,0,M00,963,3141,1559,29,1588,-1553,0,1553
2,2,0,M01,158,2557,1567,91,1658,-899,0,899
4,4,1,M00,404,3093,1588,6,1594,-1499,0,1499
1,1,1,M02,136,2401,1616,90,1706,-695,0,695
3,3,2,M00,236,1873,1616,71,1687,-186,0,186
9,9,0,M01,559,2615,1658,85,1743,-872,0,872
3,3,3,M04,236,1873,1687,99,1786,-87,0,87
6,6,1,M00,501,2430,1687,37,1724,-706,0,706
5,5,0,M02,485,2665,1706,84,1790,-875,0,875
2,2,1,M00,158,2557,1724,85,1809,-748,0,748
6,6,2,M03,501,2430,1724,61,1785,-645,0,645
12,8,1,M01,992,2717,1743,69,1812,-905,0,905
1,1,2,M04,136,2401,1786,75,1861,-540,0,540
3,3,4,M06,236,1873,1786,9,1795,-78,0,78
6,6,3,M02,501,2430,1790,13,1803,-627,0,627
3,3,5,M08,236,1873,1795,52,1847,-26,0,26
6,6,4,M06,501,2430,1803,32,1835,-595,0,595
14,4,0,M02,1177,4133,1803,14,1817,-2316,0,2316
2,2,2,M03,158,2557,1809,39,1848,-709,0,709
9,9,1,M00,559,2615,1809,13,1822,-793,0,793
5,5,1,M01,485,2665,1812,2,1814,-851,0,851
5,5,2,M05,485,2665,1814,52,1866,-799,0,799
11,9,0,M01,969,3062,1814,85,1899,-1163,0,1163
8,8,0,M00,550,3151,1822,76,1898,-1253,0,1253
9,9,2,M02,559,2615,1822,61,1883,-732,0,732
3,3,6,M07,236,1873,1847,85,1932,59,59,0
12,8,2,M03,992,2717,1848,76,1924,-793,0,793
1,1,3,M09,136,2401,1861,11,1872,-529,0,529
6,6,5,M05,501,2430,1866,21,1887,-543,0,543
2,2,3,M02,158,2557,1883,74,1957,-600,0,600
9,9,3,M06,559,2615,1883,7,1890,-725,0,725
6,6,6,M09,501,2430,1887,32,1919,-511,0,511
9,9,4,M08,559,2615,1890,64,1954,-661,0,661
15,7,1,M00,1193,3082,1898,86,1984,-1098,0,1098
13,2,0,M01,1046,3095,1899,91,1990,-1105,0,1105
12,8,3,M05,992,2717,1924,51,1975,-742,0,742
3,3,7,M03,236,1873,1932,98,2030,157,157,0
6,6,7,M08,501,2430,1954,89,2043,-387,0,387
9,9,5,M09,559,2615,1954,76,2030,-585,0,585
12,8,4,M02,992,2717,1975,85,2060,-657,0,657
11,9,1,M00,969,3062,1984,13,1997,-1065,0,1065
8,8,1,M01,550,3151,1990,69,2059,-1092,0,1092
13,2,1,M00,1046,3095,1997,85,2082,-1013,0,1013
1,1,4,M03,136,2401,2030,69,2099,-302,0,302
3,3,8,M09,236,1873,2030,22,2052,179,179,0
2,2,4,M08,158,2557,2043,90,2133,-424,0,424
6,6,8,M07,501,2430,2043,30,2073,-357,0,357
3,3,9,M05,236,1873,2052,43,2095,222,222,0
15,7,2,M01,1193,3082,2059,46,2105,-977,0,977
11,9,2,M02,969,3062,2060,61,2121,-941,0,941
12,8,5,M09,992,2717,2060,11,2071,-646,0,646
12,8,6,M06,992,2717,2071,40,2111,-606,0,606
0,0,0,M00,51,3302,2082,29,2111,-1191,0,1191
9,9,6,M05,559,2615,2095,47,2142,-473,0,473
5,5,3,M03,485,2665,2099,95,2194,-471,0,471
1,1,5,M01,136,2401,2105,28,2133,-268,0,268
12,8,7,M07,992,2717,2111,89,2200,-517,0,517
16,1,0,M00,1310,3414,2111,43,2154,-1260,0,1260
11,9,3,M06,969,3062,2121,7,2128,-934,0,934
1,1,6,M06,136,2401,2133,46,2179,-222,0,222
10,0,1,M01,963,3141,2133,78,2211,-930,0,930
11,9,4,M08,969,3062,2133,64,2197,-865,0,865
2,2,5,M05,158,2557,2142,10,2152,-405,0,405
15,7,3,M05,1193,3082,2152,74,2226,-856,0,856
7,7,1,M00,528,4218,2154,86,2240,-1978,0,1978
16,1,1,M02,1310,3414,2154,90,2244,-1170,0,1170
9,9,7,M03,559,2615,2194,52,2246,-369,0,369
5,5,4,M08,485,2665,2197,48,2245,-420,0,420
11,9,5,M09,969,3062,2197,76,2273,-789,0,789
2,2,6,M07,158,2557,2200,12,2212,-345,0,345
12,8,8,M04,992,2717,2200,26,2226,-491,0,491
4,4,2,M01,404,3093,2211,22,2233,-860,0,860
2,2,7,M06,158,2557,2212,89,2301,-256,0,256
1,1,7,M05,136,2401,2226,46,2272,-129,0,129
15,7,4,M04,1193,3082,2226,32,2258,-824,0,824
0,0,1,M01,51,3302,2233,78,2311,-991,0,991
14,4,1,M00,1177,4133,2240,6,2246,-1887,0,1887
10,0,2,M02,963,3141,2244,9,2253,-888,0,888
8,8,2,M03,550,3151,2246,76,2322,-829,0,829
9,9,8,M04,559,2615,2258,90,2348,-267,0,267
1,1,8,M07,136,2401,2272,72,2344,-57,0,57
4,4,3,M05,404,3093,2272,61,2333,-760,0,760
5,5,5,M09,485,2665,2273,72,2345,-320,0,320
15,7,5,M06,1193,3082,2301,88,2389,-693,0,693
0,0,2,M02,51,3302,2311,9,2320,-982,0,982
17,3,0,M01,1343,3576,2311,81,2392,-1184,0,1184
13,2,2,M03,1046,3095,2322,39,2361,-734,0,734
8,8,3,M05,550,3151,2333,51,2384,-767,0,767
2,2,8,M09,158,2557,2345,45,2390,-167,0,167
5,5,6,M00,485,2665,2345,47,2392,-273,0,273
4,4,4,M03,404,3093,2361,26,2387,-706,0,706
13,2,3,M02,1046,3095,2361,74,2435,-660,0,660
1,1,9,M08,136,2401,2371,30,2401,0,0,0
6,6,9,M04,501,2430,2375,55,2430,0,0,0
11,9,6,M05,969,3062,2384,47,2431,-631,0,631
10,0,3,M03,963,3141,2387,36,2423,-718,0,718
5,5,7,M06,485,2665,2392,65,2457,-208,0,208
14,4,2,M01,1177,4133,2392,22,2414,-1719,0,1719
15,7,6,M08,1193,3082,2401,19,2420,-662,0,662
7,7,2,M01,528,4218,2414,46,2460,-1758,0,1758
15,7,7,M09,1193,3082,2420,48,2468,-614,0,614
0,0,3,M03,51,3302,2423,36,2459,-843,0,843
4,4,5,M04,404,3093,2430,69,2499,-594,0,594
14,4,3,M05,1177,4133,2431,61,2492,-1641,0,1641
8,8,4,M02,550,3151,2435,85,2520,-631,0,631
13,2,4,M08,1046,3095,2435,90,2525,-570,0,570
11,9,7,M03,969,3062,2459,52,2511,-551,0,551
15,7,8,M07,1193,3082,2468,36,2504,-578,0,578
7,7,3,M05,528,4218,2492,74,2566,-1652,0,1652
5,5,8,M04,485,2665,2499,6,2505,-160,0,160
14,4,4,M03,1177,4133,2511,26,2537,-1596,0,1596
8,8,5,M09,550,3151,2520,11,2531,-620,0,620
17,3,1,M02,1343,3576,2520,95,2615,-961,0,961
2,2,9,M04,158,2557,2524,33,2557,0,0,0
4,4,6,M08,404,3093,2525,21,2546,-547,0,547
8,8,6,M06,550,3151,2531,40,2571,-580,0,580
10,0,4,M04,963,3141,2557,49,2606,-535,0,535
13,2,5,M05,1046,3095,2566,10,2576,-519,0,519
9,9,9,M07,559,2615,2570,45,2615,0,0,0
10,0,5,M05,963,3141,2606,11,2617,-524,0,524
11,9,8,M04,969,3062,2606,90,2696,-366,0,366
13,2,6,M07,1046,3095,2615,12,2627,-468,0,468
17,3,2,M00,1343,3576,2615,71,2686,-890,0,890
10,0,6,M06,963,3141,2617,62,2679,-462,0,462
5,5,9,M07,485,2665,2640,25,2665,0,0,0
12,8,9,M08,992,2717,2643,74,2717,0,0,0
4,4,7,M07,404,3093,2665,49,2714,-379,0,379
13,2,7,M06,1046,3095,2679,89,2768,-327,0,327
16,1,2,M04,1310,3414,2696,75,2771,-643,0,643
4,4,8,M09,404,3093,2714,72,2786,-307,0,307
8,8,7,M07,550,3151,2714,89,2803,-348,0,348
0,0,4,M04,51,3302,2771,49,2820,-482,0,482
13,2,8,M09,1046,3095,2786,45,2831,-264,0,264
10,0,7,M07,963,3141,2803,56,2859,-282,0,282
0,0,5,M05,51,3302,2820,11,2831,-471,0,471
8,8,8,M04,550,3151,2820,26,2846,-305,0,305
0,0,6,M06,51,3302,2831,62,2893,-409,0,409
16,1,3,M09,1310,3414,2831,11,2842,-572,0,572
16,1,4,M03,1310,3414,2842,69,2911,-503,0,503
17,3,3,M04,1343,3576,2846,99,2945,-631,0,631
10,0,8,M08,963,3141,2859,44,2903,-238,0,238
0,0,7,M07,51,3302,2893,56,2949,-353,0,353
16,1,5,M01,1310,3414,2911,28,2939,-475,0,475
16,1,6,M06,1310,3414,2939,46,2985,-429,0,429
14,4,5,M04,1177,4133,2945,69,3014,-1119,0,1119
0,0,8,M08,51,3302,2949,44,2993,-309,0,309
16,1,7,M05,1310,3414,2985,46,3031,-383,0,383
17,3,4,M06,1343,3576,2985,9,2994,-582,0,582
17,3,5,M08,1343,3576,2994,52,3046,-530,0,530
15,7,9,M03,1193,3082,3003,79,3082,0,0,0
7,7,4,M04,528,4218,3014,32,3046,-1172,0,1172
11,9,9,M07,969,3062,3017,45,3062,0,0,0
4,4,9,M06,404,3093,3040,53,3093,0,0,0
14,4,6,M08,1177,4133,3046,21,3067,-1066,0,1066
13,2,9,M04,1046,3095,3062,33,3095,0,0,0
16,1,8,M07,1310,3414,3062,72,3134,-280,0,280
8,8,9,M08,550,3151,3077,74,3151,0,0,0
7,7,5,M06,528,4218,3093,88,3181,-1037,0,1037
10,0,9,M09,963,3141,3120,21,3141,0,0,0
17,3,6,M07,1343,3576,3134,85,3219,-357,0,357
7,7,6,M08,528,4218,3181,19,3200,-1018,0,1018
7,7,7,M09,528,4218,3200,48,3248,-970,0,970
14,4,7,M07,1177,4133,3219,49,3268,-865,0,865
17,3,7,M03,1343,3576,3219,98,3317,-259,0,259
7,7,8,M07,528,4218,3268,36,3304,-914,0,914
0,0,9,M09,51,3302,3281,21,3302,0,0,0
14,4,8,M09,1177,4133,3302,72,3374,-759,0,759
17,3,8,M09,1343,3576,3374,22,3396,-180,0,180
16,1,9,M08,1310,3414,3384,30,3414,0,0,0
17,3,9,M05,1343,3576,3533,43,3576,0,0,0
14,4,9,M06,1177,4133,4080,53,4133,0,0,0
7,7,9,M03,528,4218,4139,79,4218,0,0,0
