Job,Operation,Arrival,Deadline,Machine,Start,Processing Time,End,Lateness,Tardiness,Earliness
Job_156,2,9675,12094,M3,11520,61,11581,-513,0,513
Job_170,0,10947,13244,M0,11520,29,11549,-1695,0,1695
Job_176,0,11414,15223,M1,11548,81,11629,-3594,0,3594
Job_179,0,11460,14426,M0,11549,43,11592,-2834,0,2834
Job_138,9,8617,11757,M7,11553,45,11598,-159,0,159
Job_147,5,9153,11572,M5,11558,21,11579,7,7,0
Job_150,6,9374,11672,M6,11558,62,11620,-52,0,52
Job_153,3,9480,13289,M4,11577,99,11676,-1613,0,1613
Job_154,6,9504,11790,M8,11577,21,11598,-192,0,192
Job_141,6,8914,12054,M5,11579,47,11626,-428,0,428
Job_147,6,9153,11572,M9,11579,32,11611,39,39,0
Job_140,2,8812,12115,M3,11581,39,11620,-495,0,495
Job_154,7,9504,11790,M7,11598,49,11647,-143,0,143
Job_159,1,9770,12910,M0,11598,13,11611,-1299,0,1299
Job_124,8,7858,11667,M9,11611,22,11633,-34,0,34
Job_147,7,9153,11572,M8,11611,89,11700,128,128,0
Job_142,2,9008,12817,M0,11614,71,11685,-1132,0,1132
Job_168,0,10732,13018,M2,11614,14,11628,-1390,0,1390
Job_139,5,8644,11778,M6,11620,88,11708,-70,0,70
Job_148,4,9176,12142,M3,11620,69,11689,-453,0,453
Job_156,3,9675,12094,M2,11628,13,11641,-453,0,453
Job_155,1,9551,12436,M1,11629,2,11631,-805,0,805
Job_170,1,10947,13244,M1,11631,78,11709,-1535,0,1535
Job_124,9,7858,11667,M5,11633,43,11676,9,9,0
Job_136,8,8509,11812,M9,11633,45,11678,-134,0,134
Job_140,3,8812,12115,M2,11641,74,11715,-400,0,400
Job_150,7,9374,11672,M7,11647,56,11703,31,31,0
Job_145,2,9103,11988,M5,11676,52,11728,-260,0,260
Job_151,2,9448,12414,M4,11676,75,11751,-663,0,663
Job_154,8,9504,11790,M9,11678,72,11750,-40,0,40
Job_168,1,10732,13018,M0,11685,6,11691,-1327,0,1327
Job_141,7,8914,12054,M3,11689,52,11741,-313,0,313
Job_169,0,10833,13799,M0,11691,43,11734,-2065,0,2065
Job_147,8,9153,11572,M7,11703,30,11733,161,161,0
Job_150,8,9374,11672,M8,11703,44,11747,75,75,0
Job_153,4,9480,13289,M6,11708,9,11717,-1572,0,1572
Job_167,0,10632,13052,M1,11709,46,11755,-1297,0,1297
Job_131,4,8253,11725,M2,11715,85,11800,75,75,0
Job_156,4,9675,12094,M6,11717,32,11749,-345,0,345
Job_135,6,8454,12263,M7,11734,85,11819,-444,0,444
Job_161,0,10216,12514,M0,11734,29,11763,-751,0,751
Job_145,3,9103,11988,M3,11741,95,11836,-152,0,152
Job_139,6,8644,11778,M8,11747,19,11766,-12,0,12
Job_149,5,9268,12402,M6,11749,88,11837,-565,0,565
Job_156,5,9675,12094,M5,11749,21,11770,-324,0,324
Job_150,9,9374,11672,M9,11750,21,11771,99,99,0
Job_147,9,9153,11572,M4,11751,55,11806,234,234,0
Job_168,2,10732,13018,M1,11755,22,11777,-1241,0,1241
Job_163,0,10299,13771,M0,11763,76,11839,-1932,0,1932
Job_140,4,8812,12115,M8,11766,90,11856,-259,0,259
Job_155,2,9551,12436,M5,11770,52,11822,-614,0,614
Job_139,7,8644,11778,M9,11771,48,11819,41,41,0
Job_165,0,10535,14344,M1,11777,81,11858,-2486,0,2486
Job_159,2,9770,12910,M2,11800,61,11861,-1049,0,1049
Job_136,9,8509,11812,M4,11806,33,11839,27,27,0
Job_131,5,8253,11725,M9,11819,11,11830,105,105,0
Job_139,8,8644,11778,M7,11819,36,11855,77,77,0
Job_156,6,9675,12094,M9,11830,32,11862,-232,0,232
Job_143,2,9040,12512,M3,11836,76,11912,-600,0,600
Job_131,6,8253,11725,M6,11837,40,11877,152,152,0
Job_141,8,8914,12054,M4,11839,90,11929,-125,0,125
Job_167,1,10632,13052,M0,11839,37,11876,-1176,0,1176
Job_140,5,8812,12115,M5,11856,10,11866,-249,0,249
Job_149,6,9268,12402,M8,11856,19,11875,-527,0,527
Job_176,1,11414,15223,M2,11861,95,11956,-3267,0,3267
Job_151,3,9448,12414,M9,11864,11,11875,-539,0,539
Job_140,6,8812,12115,M7,11866,12,11878,-237,0,237
Job_168,3,10732,13018,M5,11866,61,11927,-1091,0,1091
Job_148,5,9176,12142,M1,11867,28,11895,-247,0,247
Job_145,4,9103,11988,M8,11875,48,11923,-65,0,65
Job_149,7,9268,12402,M9,11875,48,11923,-479,0,479
Job_172,0,10953,14424,M0,11876,76,11952,-2472,0,2472
Job_159,3,9770,12910,M6,11877,7,11884,-1026,0,1026
Job_131,7,8253,11725,M7,11878,89,11967,242,242,0
Job_154,9,9504,11790,M6,11884,53,11937,147,147,0
Job_161,1,10216,12514,M1,11895,78,11973,-541,0,541
Job_139,9,8644,11778,M3,11912,79,11991,213,213,0
Job_145,5,9103,11988,M9,11923,72,11995,7,7,0
Job_156,7,9675,12094,M8,11923,89,12012,-82,0,82
Job_157,4,9680,12814,M4,11929,32,11961,-853,0,853
Job_148,6,9176,12142,M6,11937,46,11983,-159,0,159
Job_180,0,11478,13776,M0,11952,29,11981,-1795,0,1795
Job_171,0,10947,13233,M2,11956,14,11970,-1263,0,1263
Job_131,8,8253,11725,M4,11967,26,11993,268,268,0
Job_141,9,8914,12054,M7,11967,45,12012,-42,0,42
Job_175,0,11350,14485,M2,11970,31,12001,-2484,0,2484
Job_181,0,11488,14791,M1,11973,91,12064,-2727,0,2727
Job_171,1,10947,13233,M0,11981,6,11987,-1246,0,1246
Job_140,7,8812,12115,M6,11983,89,12072,-43,0,43
Job_148,7,9176,12142,M5,11983,46,12029,-113,0,113
Job_155,3,9551,12436,M3,11991,95,12086,-350,0,350
Job_145,6,9103,11988,M0,11995,47,12042,54,54,0
Job_146,8,9153,11438,M9,11995,72,12067,629,629,0
Job_161,2,10216,12514,M2,12001,9,12010,-504,0,504
Job_160,0,10092,13227,M2,12010,31,12041,-1186,0,1186
Job_131,9,8253,11725,M8,12012,74,12086,361,361,0
Job_156,8,9675,12094,M7,12012,30,12042,-52,0,52
Job_143,3,9040,12512,M5,12037,51,12088,-424,0,424
Job_148,8,9176,12142,M7,12042,72,12114,-28,0,28
Job_156,9,9675,12094,M4,12042,55,12097,3,3,0
Job_176,2,11414,15223,M0,12042,71,12113,-3110,0,3110
Job_171,2,10947,13233,M1,12064,22,12086,-1147,0,1147
Job_140,8,8812,12115,M9,12072,45,12117,2,2,0
Job_145,7,9103,11988,M6,12072,65,12137,149,149,0
Job_135,7,8454,12263,M3,12086,98,12184,-79,0,79
Job_178,0,11447,14587,M1,12086,85,12171,-2416,0,2416
Job_143,4,9040,12512,M2,12088,85,12173,-339,0,339
Job_171,3,10947,13233,M5,12088,61,12149,-1084,0,1084
Job_160,1,10092,13227,M0,12113,86,12199,-1028,0,1028
Job_148,9,9176,12142,M8,12114,30,12144,2,2,0
Job_149,8,9268,12402,M7,12114,36,12150,-252,0,252
Job_140,9,8812,12115,M4,12117,33,12150,35,35,0
Job_146,9,9153,11438,M6,12137,53,12190,752,752,0
Job_155,4,9551,12436,M8,12144,48,12192,-244,0,244
Job_145,8,9103,11988,M4,12150,6,12156,168,168,0
Job_142,3,9008,12817,M4,12156,99,12255,-562,0,562
Job_145,9,9103,11988,M7,12156,25,12181,193,193,0
Job_143,5,9040,12512,M9,12173,11,12184,-328,0,328
Job_170,2,10947,13244,M2,12173,9,12182,-1062,0,1062
Job_135,8,8454,12263,M9,12184,22,12206,-57,0,57
Job_151,4,9448,12414,M3,12184,69,12253,-161,0,161
Job_143,6,9040,12512,M6,12190,40,12230,-282,0,282
Job_159,4,9770,12910,M8,12192,64,12256,-654,0,654
Job_160,2,10092,13227,M1,12199,46,12245,-982,0,982
Job_178,1,11447,14587,M0,12199,13,12212,-2375,0,2375
Job_155,5,9551,12436,M9,12206,72,12278,-158,0,158
Job_135,9,8454,12263,M5,12220,43,12263,0,0,0
Job_143,7,9040,12512,M7,12230,89,12319,-193,0,193
Job_157,5,9680,12814,M6,12230,88,12318,-496,0,496
Job_151,5,9448,12414,M1,12253,28,12281,-133,0,133
Job_152,2,9477,12781,M3,12253,39,12292,-489,0,489
Job_153,5,9480,13289,M8,12256,52,12308,-981,0,981
Job_160,3,10092,13227,M5,12263,74,12337,-890,0,890
Job_159,5,9770,12910,M9,12278,76,12354,-556,0,556
Job_155,6,9551,12436,M0,12280,47,12327,-109,0,109
Job_177,0,11443,13862,M1,12281,46,12327,-1535,0,1535
Job_152,3,9477,12781,M2,12292,74,12366,-415,0,415
Job_161,3,10216,12514,M3,12292,36,12328,-186,0,186
Job_142,4,9008,12817,M6,12318,9,12327,-490,0,490
Job_157,6,9680,12814,M8,12318,19,12337,-477,0,477
Job_153,6,9480,13289,M7,12319,85,12404,-885,0,885
Job_155,7,9551,12436,M6,12327,65,12392,-44,0,44
Job_166,0,10574,13714,M1,12327,85,12412,-1302,0,1302
Job_175,1,11350,14485,M0,12327,86,12413,-2072,0,2072
Job_149,9,9268,12402,M3,12328,79,12407,5,5,0
Job_161,4,10216,12514,M4,12328,49,12377,-137,0,137
Job_142,5,9008,12817,M8,12337,52,12389,-428,0,428
Job_157,7,9680,12814,M9,12354,48,12402,-412,0,412
Job_159,6,9770,12910,M5,12354,47,12401,-509,0,509
Job_162,0,10278,13163,M2,12366,84,12450,-713,0,713
Job_151,6,9448,12414,M6,12392,46,12438,24,24,0
Job_155,8,9551,12436,M4,12393,6,12399,-37,0,37
Job_143,8,9040,12512,M4,12399,26,12425,-87,0,87
Job_161,5,10216,12514,M5,12401,11,12412,-102,0,102
Job_155,9,9551,12436,M7,12407,25,12432,-4,0,4
Job_159,7,9770,12910,M3,12407,52,12459,-451,0,451
Job_175,2,11350,14485,M1,12413,46,12459,-2026,0,2026
Job_181,1,11488,14791,M0,12413,85,12498,-2293,0,2293
Job_143,9,9040,12512,M8,12425,74,12499,-13,0,13
Job_160,4,10092,13227,M4,12425,32,12457,-770,0,770
Job_142,6,9008,12817,M7,12432,85,12517,-300,0,300
Job_151,7,9448,12414,M5,12438,46,12484,70,70,0
Job_161,6,10216,12514,M6,12438,62,12500,-14,0,14
Job_178,2,11447,14587,M2,12450,61,12511,-2076,0,2076
Job_159,8,9770,12910,M4,12459,90,12549,-361,0,361
Job_162,1,10278,13163,M1,12459,2,12461,-702,0,702
Job_167,2,10632,13052,M3,12459,61,12520,-532,0,532
Job_174,0,11144,14447,M1,12461,91,12552,-1895,0,1895
Job_175,3,11350,14485,M5,12484,74,12558,-1927,0,1927
Job_166,1,10574,13714,M0,12498,13,12511,-1203,0,1203
Job_152,4,9477,12781,M8,12499,90,12589,-192,0,192
Job_160,5,10092,13227,M6,12500,88,12588,-639,0,639
Job_166,2,10574,13714,M2,12511,61,12572,-1142,0,1142
Job_177,1,11443,13862,M0,12511,37,12548,-1314,0,1314
Job_151,8,9448,12414,M7,12517,72,12589,175,175,0
Job_142,7,9008,12817,M3,12520,98,12618,-199,0,199
Job_176,3,11414,15223,M4,12549,99,12648,-2575,0,2575
Job_163,1,10299,13771,M1,12552,69,12621,-1150,0,1150
Job_174,1,11144,14447,M0,12552,85,12637,-1810,0,1810
Job_165,1,10535,14344,M2,12572,95,12667,-1677,0,1677
Job_166,3,10574,13714,M6,12588,7,12595,-1119,0,1119
Job_151,9,9448,12414,M8,12589,30,12619,205,205,0
Job_152,5,9477,12781,M5,12589,10,12599,-182,0,182
Job_178,3,11447,14587,M6,12595,7,12602,-1985,0,1985
Job_152,6,9477,12781,M7,12599,12,12611,-170,0,170
Job_162,2,10278,13163,M5,12599,52,12651,-512,0,512
Job_157,8,9680,12814,M7,12611,36,12647,-167,0,167
Job_152,7,9477,12781,M6,12613,89,12702,-79,0,79
Job_168,4,10732,13018,M3,12618,26,12644,-374,0,374
Job_142,8,9008,12817,M9,12619,22,12641,-176,0,176
Job_160,6,10092,13227,M8,12619,19,12638,-589,0,589
Job_164,0,10397,13700,M1,12621,91,12712,-988,0,988
Job_166,4,10574,13714,M8,12638,64,12702,-1012,0,1012
Job_160,7,10092,13227,M9,12641,48,12689,-538,0,538
Job_158,2,9747,13219,M3,12644,76,12720,-499,0,499
Job_161,7,10216,12514,M7,12647,56,12703,189,189,0
Job_168,5,10732,13018,M4,12648,69,12717,-301,0,301
Job_165,2,10535,14344,M0,12667,71,12738,-1606,0,1606
Job_167,3,10632,13052,M2,12667,13,12680,-372,0,372
Job_169,1,10833,13799,M2,12680,90,12770,-1029,0,1029
Job_152,8,9477,12781,M9,12702,45,12747,-34,0,34
Job_176,4,11414,15223,M6,12702,9,12711,-2512,0,2512
Job_160,8,10092,13227,M7,12703,36,12739,-488,0,488
Job_161,8,10216,12514,M8,12703,44,12747,233,233,0
Job_167,4,10632,13052,M6,12711,32,12743,-309,0,309
Job_180,1,11478,13776,M1,12712,78,12790,-986,0,986
Job_157,9,9680,12814,M3,12720,79,12799,-15,0,15
Job_164,1,10397,13700,M0,12738,85,12823,-877,0,877
Job_167,5,10632,13052,M5,12743,21,12764,-288,0,288
Job_161,9,10216,12514,M9,12747,21,12768,254,254,0
Job_168,6,10732,13018,M8,12747,21,12768,-250,0,250
Job_152,9,9477,12781,M4,12748,33,12781,0,0,0
Job_167,6,10632,13052,M9,12768,32,12800,-252,0,252
Job_168,7,10732,13018,M7,12768,49,12817,-201,0,201
Job_173,0,10996,13881,M2,12770,84,12854,-1027,0,1027
Job_142,9,9008,12817,M5,12774,43,12817,0,0,0
Job_175,4,11350,14485,M4,12781,32,12813,-1672,0,1672
Job_171,4,10947,13233,M3,12799,26,12825,-408,0,408
Job_167,7,10632,13052,M8,12800,89,12889,-163,0,163
Job_175,5,11350,14485,M6,12813,88,12901,-1584,0,1584
Job_158,3,9747,13219,M5,12817,51,12868,-351,0,351
Job_168,8,10732,13018,M9,12817,72,12889,-129,0,129
Job_162,3,10278,13163,M3,12825,95,12920,-243,0,243
Job_171,5,10947,13233,M4,12825,69,12894,-339,0,339
Job_173,1,10996,13881,M1,12854,2,12856,-1025,0,1025
Job_180,2,11478,13776,M2,12854,9,12863,-913,0,913
Job_172,1,10953,14424,M1,12856,69,12925,-1499,0,1499
Job_159,9,9770,12910,M7,12865,45,12910,0,0,0
Job_158,4,9747,13219,M2,12868,85,12953,-266,0,266
Job_173,2,10996,13881,M5,12868,52,12920,-961,0,961
Job_171,6,10947,13233,M8,12894,21,12915,-318,0,318
Job_167,8,10632,13052,M7,12910,30,12940,-112,0,112
Job_168,9,10732,13018,M6,12911,53,12964,-54,0,54
Job_162,4,10278,13163,M8,12920,48,12968,-195,0,195
Job_170,3,10947,13244,M3,12920,36,12956,-288,0,288
Job_171,7,10947,13233,M7,12940,49,12989,-244,0,244
Job_158,5,9747,13219,M9,12953,11,12964,-255,0,255
Job_179,1,11460,14426,M2,12953,90,13043,-1383,0,1383
Job_153,7,9480,13289,M3,12956,98,13054,-235,0,235
Job_170,4,10947,13244,M4,12956,49,13005,-239,0,239
Job_158,6,9747,13219,M6,12964,40,13004,-215,0,215
Job_162,5,10278,13163,M9,12968,72,13040,-123,0,123
Job_176,5,11414,15223,M8,12968,52,13020,-2203,0,2203
Job_158,7,9747,13219,M7,13004,89,13093,-126,0,126
Job_167,9,10632,13052,M4,13005,55,13060,8,8,0
Job_170,5,10947,13244,M5,13005,11,13016,-228,0,228
Job_170,6,10947,13244,M6,13016,62,13078,-166,0,166
Job_178,4,11447,14587,M8,13020,64,13084,-1503,0,1503
Job_162,6,10278,13163,M0,13040,47,13087,-76,0,76
Job_153,8,9480,13289,M9,13054,22,13076,-213,0,213
Job_163,2,10299,13771,M3,13054,76,13130,-641,0,641
Job_171,8,10947,13233,M9,13076,72,13148,-85,0,85
Job_175,6,11350,14485,M8,13084,19,13103,-1382,0,1382
Job_162,7,10278,13163,M6,13087,65,13152,-11,0,11
Job_158,8,9747,13219,M4,13093,26,13119,-100,0,100
Job_170,7,10947,13244,M7,13093,56,13149,-95,0,95
Job_158,9,9747,13219,M8,13119,74,13193,-26,0,26
Job_163,3,10299,13771,M5,13130,51,13181,-590,0,590
Job_160,9,10092,13227,M3,13143,79,13222,-5,0,5
Job_166,5,10574,13714,M9,13148,76,13224,-490,0,490
Job_162,8,10278,13163,M4,13152,6,13158,-5,0,5
Job_162,9,10278,13163,M7,13158,25,13183,20,20,0
Job_169,2,10833,13799,M4,13158,75,13233,-566,0,566
Job_171,9,10947,13233,M6,13180,53,13233,0,0,0
Job_163,4,10299,13771,M2,13181,85,13266,-505,0,505
Job_176,6,11414,15223,M7,13183,85,13268,-1955,0,1955
Job_170,8,10947,13244,M8,13193,44,13237,-7,0,7
Job_180,3,11478,13776,M3,13222,36,13258,-518,0,518
Job_170,9,10947,13244,M9,13237,21,13258,14,14,0
Job_153,9,9480,13289,M5,13246,43,13289,0,0,0
Job_164,2,10397,13700,M3,13258,39,13297,-403,0,403
Job_180,4,11478,13776,M4,13258,49,13307,-469,0,469
Job_163,5,10299,13771,M9,13266,11,13277,-494,0,494
Job_163,6,10299,13771,M6,13277,40,13317,-454,0,454
Job_169,3,10833,13799,M9,13277,11,13288,-511,0,511
Job_178,5,11447,14587,M9,13288,76,13364,-1223,0,1223
Job_164,3,10397,13700,M2,13297,74,13371,-329,0,329
Job_169,4,10833,13799,M3,13297,69,13366,-433,0,433
Job_179,2,11460,14426,M4,13307,75,13382,-1044,0,1044
Job_180,5,11478,13776,M5,13307,11,13318,-458,0,458
Job_163,7,10299,13771,M7,13317,89,13406,-365,0,365
Job_166,6,10574,13714,M5,13318,47,13365,-349,0,349
Job_180,6,11478,13776,M6,13318,62,13380,-396,0,396
Job_175,7,11350,14485,M9,13364,48,13412,-1073,0,1073
Job_178,6,11447,14587,M5,13365,47,13412,-1175,0,1175
Job_169,5,10833,13799,M1,13366,28,13394,-405,0,405
Job_177,2,11443,13862,M3,13366,61,13427,-435,0,435
Job_164,4,10397,13700,M8,13371,90,13461,-239,0,239
Job_165,3,10535,14344,M4,13382,99,13481,-863,0,863
Job_169,6,10833,13799,M6,13394,46,13440,-359,0,359
Job_180,7,11478,13776,M7,13406,56,13462,-314,0,314
Job_179,3,11460,14426,M9,13412,11,13423,-1003,0,1003
Job_173,3,10996,13881,M3,13427,95,13522,-359,0,359
Job_177,3,11443,13862,M2,13427,13,13440,-422,0,422
Job_177,4,11443,13862,M6,13440,32,13472,-390,0,390
Job_164,5,10397,13700,M5,13461,10,13471,-229,0,229
Job_180,8,11478,13776,M8,13462,44,13506,-270,0,270
Job_164,6,10397,13700,M7,13471,12,13483,-217,0,217
Job_169,7,10833,13799,M5,13471,46,13517,-282,0,282
Job_163,8,10299,13771,M4,13481,26,13507,-264,0,264
Job_164,7,10397,13700,M6,13483,89,13572,-128,0,128
Job_175,8,11350,14485,M7,13483,36,13519,-966,0,966
Job_177,5,11443,13862,M5,13517,21,13538,-324,0,324
Job_169,8,10833,13799,M7,13519,72,13591,-208,0,208
Job_166,7,10574,13714,M3,13522,52,13574,-140,0,140
Job_173,4,10996,13881,M8,13522,48,13570,-311,0,311
Job_177,6,11443,13862,M9,13538,32,13570,-292,0,292
Job_177,7,11443,13862,M8,13570,89,13659,-203,0,203
Job_164,8,10397,13700,M9,13572,45,13617,-83,0,83
Job_165,4,10535,14344,M6,13572,9,13581,-763,0,763
Job_166,8,10574,13714,M4,13574,90,13664,-50,0,50
Job_172,2,10953,14424,M3,13574,76,13650,-774,0,774
Job_173,5,10996,13881,M9,13617,72,13689,-192,0,192
Job_172,3,10953,14424,M5,13650,51,13701,-723,0,723
Job_181,2,11488,14791,M3,13650,39,13689,-1102,0,1102
Job_164,9,10397,13700,M4,13667,33,13700,0,0,0
Job_166,9,10574,13714,M7,13669,45,13714,0,0,0
Job_173,6,10996,13881,M0,13689,47,13736,-145,0,145
Job_176,7,11414,15223,M3,13689,98,13787,-1436,0,1436
Job_181,3,11488,14791,M2,13689,74,13763,-1028,0,1028
Job_163,9,10299,13771,M8,13695,74,13769,-2,0,2
Job_177,8,11443,13862,M7,13714,30,13744,-118,0,118
Job_173,7,10996,13881,M6,13736,65,13801,-80,0,80
Job_180,9,11478,13776,M9,13755,21,13776,0,0,0
Job_172,4,10953,14424,M2,13763,85,13848,-576,0,576
Job_169,9,10833,13799,M8,13769,30,13799,0,0,0
Job_176,8,11414,15223,M9,13787,22,13809,-1414,0,1414
Job_179,4,11460,14426,M3,13787,69,13856,-570,0,570
Job_165,5,10535,14344,M8,13799,52,13851,-493,0,493
Job_173,8,10996,13881,M4,13801,6,13807,-74,0,74
Job_177,9,11443,13862,M4,13807,55,13862,0,0,0
Job_172,5,10953,14424,M9,13848,11,13859,-565,0,565
Job_181,4,11488,14791,M8,13851,90,13941,-850,0,850
Job_173,9,10996,13881,M7,13856,25,13881,0,0,0
Job_174,2,11144,14447,M3,13856,39,13895,-552,0,552
Job_179,5,11460,14426,M1,13856,28,13884,-542,0,542
Job_172,6,10953,14424,M6,13859,40,13899,-525,0,525
Job_174,3,11144,14447,M2,13895,74,13969,-478,0,478
Job_178,7,11447,14587,M3,13895,52,13947,-640,0,640
Job_172,7,10953,14424,M7,13899,89,13988,-436,0,436
Job_179,6,11460,14426,M6,13899,46,13945,-481,0,481
Job_181,5,11488,14791,M5,13941,10,13951,-840,0,840
Job_178,8,11447,14587,M4,13947,90,14037,-550,0,550
Job_179,7,11460,14426,M5,13951,46,13997,-429,0,429
Job_174,4,11144,14447,M8,13969,90,14059,-388,0,388
Job_181,6,11488,14791,M7,13988,12,14000,-791,0,791
Job_179,8,11460,14426,M7,14000,72,14072,-354,0,354
Job_181,7,11488,14791,M6,14000,89,14089,-702,0,702
Job_172,8,10953,14424,M4,14037,26,14063,-361,0,361
Job_174,5,11144,14447,M5,14059,10,14069,-378,0,378
Job_174,6,11144,14447,M7,14072,12,14084,-363,0,363
Job_165,6,10535,14344,M7,14084,85,14169,-175,0,175
Job_174,7,11144,14447,M6,14089,89,14178,-269,0,269
Job_181,8,11488,14791,M9,14089,45,14134,-657,0,657
Job_165,7,10535,14344,M3,14169,98,14267,-77,0,77
Job_174,8,11144,14447,M9,14178,45,14223,-224,0,224
Job_165,8,10535,14344,M9,14267,22,14289,-55,0,55
Job_165,9,10535,14344,M5,14301,43,14344,0,0,0
Job_172,9,10953,14424,M8,14322,74,14396,-28,0,28
Job_179,9,11460,14426,M8,14396,30,14426,0,0,0
Job_175,9,11350,14485,M3,14406,79,14485,0,0,0
Job_174,9,11144,14447,M4,14414,33,14447,0,0,0
Job_178,9,11447,14587,M7,14542,45,14587,0,0,0
Job_181,9,11488,14791,M4,14758,33,14791,0,0,0
Job_176,9,11414,15223,M5,15180,43,15223,0,0,0
